date,states,positive,negative,pending,hospitalizedCurrently,hospitalizedCumulative,inIcuCurrently,inIcuCumulative,onVentilatorCurrently,onVentilatorCumulative,recovered,dateChecked,death,hospitalized,lastModified,total,totalTestResults,posNeg,deathIncrease,hospitalizedIncrease,negativeIncrease,positiveIncrease,totalTestResultsIncrease,hash
20200812,56,5172509,58558796,4174,47954,340117,9553,15524,2604,1629,1755225,2020-08-12T07:00:00Z,157776,340117,2020-08-12T07:00:00Z,63735479,63731305,63731305,1503,3055,423013,56035,479048,2a3c7953c4e43732a92d3ebc466d83438d0684e5
20200811,56,5116474,58135783,4118,48500,337062,9136,15331,2415,1612,1714960,2020-08-11T07:00:00Z,156273,337062,2020-08-11T07:00:00Z,63256375,63252257,63252257,1326,2715,683489,55594,739083,86f3263bb4c1cf2ffcff638e335460458b72dc5e
20200810,56,5060880,57452294,3966,48612,334347,9216,15158,2533,1592,1670755,2020-08-10T07:00:00Z,154947,334347,2020-08-10T07:00:00Z,62517140,62513174,62513174,426,1654,674422,41807,716229,e7b6ea95e3787f2ed267bc631a8b65494191c255
20200809,56,5019073,56777872,3871,49048,332693,9303,15081,2507,1578,1656888,2020-08-09T07:00:00Z,154521,332693,2020-08-09T07:00:00Z,61800816,61796945,61796945,616,838,661522,51319,712841,c95d8f2e5ec47c300b0c47a88d5a630e768ef0cb
20200808,56,4967754,56116350,3888,50016,331855,9652,15024,2566,1561,1643142,2020-08-08T07:00:00Z,153905,331855,2020-08-08T07:00:00Z,61087992,61084104,61084104,1089,1431,614455,54091,668546,babb812d992828dd1588707fc753d3c2f8dbac5b
20200807,56,4913663,55501895,3988,51325,330424,9670,14925,2617,1549,1623870,2020-08-07T07:00:00Z,152816,330424,2020-08-07T07:00:00Z,60419546,60415558,60415558,1333,8036,701363,61520,762883,70cde065d7ef7a9c17911410f518ffb709050df5
20200806,56,4852143,54800532,3903,53015,322388,9976,14810,2718,1534,1598624,2020-08-06T07:00:00Z,151483,322388,2020-08-06T07:00:00Z,59656578,59652675,59652675,1251,2682,677516,54184,731700,9e56ca7ffcea6e86a5bf3c054ff87cdfdd52b56a
20200805,56,4797959,54123016,3842,53284,319706,9970,14687,2719,1524,1577851,2020-08-05T07:00:00Z,150232,319706,2020-08-05T07:00:00Z,58924817,58920975,58920975,1425,2269,629272,52265,681537,1b974bbd4ca72c6871bc471637e657cb4f343c43
20200804,56,4745694,53493744,3789,53238,317437,10208,14537,2701,1493,1528979,2020-08-04T07:00:00Z,148807,317437,2020-08-04T07:00:00Z,58243227,58239438,58239438,1176,4490,644018,51568,695586,2433705039d2dffa63264d0a4e7b979aa0af6201
20200803,56,4694126,52849726,3662,53303,312947,10216,14370,2659,1463,1513446,2020-08-03T07:00:00Z,147631,312947,2020-08-03T07:00:00Z,57547514,57543852,57543852,519,1724,682129,49561,731690,800cc656708ba7cb8b979a4a8685d155f789fbf6
20200802,56,4644565,52167597,3888,53922,311223,10405,14288,2645,1448,1468689,2020-08-02T07:00:00Z,147112,311223,2020-08-02T07:00:00Z,56816050,56812162,56812162,498,817,664903,48266,713169,1510f2350486d0abb4c8cd904c5559b464b3d1e0
20200801,56,4596299,51502694,3975,54484,310406,10428,14227,2698,1445,1461885,2020-08-01T07:00:00Z,146614,310406,2020-08-01T07:00:00Z,56102968,56098993,56098993,1189,2318,665318,60692,726010,cc2d3008431b8d166b838d9b7e99ece335598353
20200731,56,4535607,50837376,3956,55540,308088,10472,14044,2703,1437,1438160,2020-07-31T07:00:00Z,145425,308088,2020-07-31T07:00:00Z,55376939,55372983,55372983,1311,2627,658227,67755,725982,848f1000928376d46d60d4cc279c80752cb6bbe2
20200730,56,4467852,50179149,3947,56464,305461,10513,13875,2760,1415,1413957,2020-07-30T07:00:00Z,144114,305461,2020-07-30T07:00:00Z,54650948,54647001,54647001,1259,3383,736388,69466,805854,da66037a497ec46afcaf7043295d2b4382db4b0c
20200729,56,4398386,49442761,3840,57332,302078,10539,13744,2772,1400,1390568,2020-07-29T07:00:00Z,142855,302078,2020-07-29T07:00:00Z,53844987,53841147,53841147,1492,2934,786357,66969,853326,f27d2450ca2e63e3e5825c345fac8326974a7b8d
20200728,56,4331417,48656404,3600,57091,299144,10463,13559,2752,1372,1355363,2020-07-28T07:00:00Z,141363,299144,2020-07-28T07:00:00Z,52991421,52987821,52987821,1121,4672,679258,56229,735487,5b3b7e93da6e32386978a3ce300a41fc8435d7e0
20200727,56,4275188,47977146,3398,59023,294472,10328,13412,2720,1356,1325804,2020-07-27T07:00:00Z,140242,294472,2020-07-27T07:00:00Z,52255732,52252334,52252334,1059,1690,705706,55134,760840,36717d8b902318e392e6cd81a6156b2829488392
20200726,56,4220054,47271440,3361,58614,292782,10353,13343,2723,1336,1297863,2020-07-26T07:00:00Z,139183,292782,2020-07-26T07:00:00Z,51494855,51491494,51491494,558,1435,794098,61713,855811,27aa2fc0c75be7d9ab77c7d11459041b7531e801
20200725,56,4158341,46477342,3377,59227,291347,10380,13279,2729,1300,1279414,2020-07-25T07:00:00Z,138625,291347,2020-07-25T07:00:00Z,50639060,50635683,50635683,1023,1977,719286,65075,784361,a7a5aa814bc39941282b36de592d5b36477460e7
20200724,56,4093266,45758056,3409,59716,289370,10395,13182,2711,1297,1261624,2020-07-24T07:00:00Z,137602,289370,2020-07-24T07:00:00Z,49854731,49851322,49851322,1176,3032,851672,75204,926876,f9f878ab3c697c51dc9d32ef487a26ef583f3355
20200723,56,4018062,44906384,3179,59704,286338,10414,12933,2465,1280,1233269,2020-07-23T07:00:00Z,136426,286338,2020-07-23T07:00:00Z,48927625,48924446,48924446,1055,2509,769235,71354,840589,f649d6cf525f5818ef15ecc5a55b63784532184a
20200722,56,3946708,44137149,3051,59675,283829,10457,12790,2440,1258,1210849,2020-07-22T07:00:00Z,135371,283829,2020-07-22T07:00:00Z,48086908,48083857,48083857,1171,2248,726352,69150,795502,31e98c950d64bf9e13e93dccaf2a3047c2e25682
20200721,56,3877558,43410797,3197,59362,281581,6711,12629,2414,1242,1182931,2020-07-21T07:00:00Z,134200,281581,2020-07-21T07:00:00Z,47291552,47288355,47288355,1038,2551,686606,63642,750248,0b98a975e0e92f795bb028d02cd3f7f30aa7b76e
20200720,56,3813916,42724191,3003,58371,279030,6558,12475,2403,1223,1160087,2020-07-20T07:00:00Z,133162,279030,2020-07-20T07:00:00Z,46541110,46538107,46538107,363,1647,654044,56971,711015,f8837b963b395162a0475c45cd0d140850073fa4
20200719,56,3756945,42070147,3052,57885,277383,6384,12393,2362,1216,1131171,2020-07-19T07:00:00Z,132799,277383,2020-07-19T07:00:00Z,45830144,45827092,45827092,526,944,733624,64884,798508,7024c9320d1426bce1fee1f7bcfc28267f9afd04
20200718,56,3692061,41336523,3032,57645,276439,6396,12342,2343,1211,1122720,2020-07-18T07:00:00Z,132273,276439,2020-07-18T07:00:00Z,45031616,45028584,45028584,872,2003,696452,65180,761632,b80dc91d43dcc3344e66c65b812690809fb6907b
20200717,56,3626881,40640071,3002,57761,274436,6453,12243,2353,1200,1106844,2020-07-17T07:00:00Z,131401,274436,2020-07-17T07:00:00Z,44269954,44266952,44266952,951,2678,760159,77233,837392,f05c6bcf52ab48ccc11cd9133705231fd8eb9fb1
20200716,56,3549648,39879912,2929,57442,271758,6359,12091,2317,1175,1090645,2020-07-16T07:00:00Z,130450,271758,2020-07-16T07:00:00Z,43432489,43429560,43429560,947,2215,756611,70953,827564,b5c5c81ca9afc99eee1dc58352cc7567d33d97dc
20200715,56,3478695,39123301,2947,56144,269543,6317,12002,2317,1166,1075882,2020-07-15T07:00:00Z,129503,269543,2020-07-15T07:00:00Z,42604943,42601996,42601996,858,2416,696615,65382,761997,3485070179d65d6fb20d9755ca2e5d98daef8a8a
20200714,56,3413313,38426686,960,55565,267127,6235,11857,2263,1154,1049098,2020-07-14T07:00:00Z,128645,267127,2020-07-14T07:00:00Z,41840959,41839999,41839999,736,2262,707103,62879,769982,1aa4cd63b2989ed781b495089d03cf836ca4331a
20200713,56,3350434,37719583,2610,53988,264865,6074,11749,2259,1142,1031939,2020-07-13T07:00:00Z,127909,264865,2020-07-13T07:00:00Z,41072627,41070017,41070017,327,1214,635111,58465,693576,068c9bf72f9e472122a3bb6a2ecf7d2cc3c18598
20200712,56,3291969,37084472,2639,52727,263651,5930,11679,2182,1136,1006326,2020-07-12T07:00:00Z,127582,263651,2020-07-12T07:00:00Z,40379080,40376441,40376441,476,939,697346,60978,758324,504965a65cbd06f34d69555f603076efe110a8d2
20200711,56,3230991,36387126,2618,51859,262712,5939,11612,2169,1128,995576,2020-07-11T07:00:00Z,127106,262712,2020-07-11T07:00:00Z,39620735,39618117,39618117,757,5141,635437,63007,698444,cc9927ecf6b696e2db358128cee381c6f86c4dea
20200710,56,3167984,35751689,2493,51595,257571,5896,11523,2197,1118,983185,2020-07-10T07:00:00Z,126349,257571,2020-07-10T07:00:00Z,38922166,38919673,38919673,854,2318,744161,66645,810806,d2536d14d089038c8f931681044d17727ef6b512
20200709,56,3101339,35007528,2530,43934,255253,5845,11370,2127,1138,969111,2020-07-09T07:00:00Z,125495,255253,2020-07-09T07:00:00Z,38111397,38108867,38108867,867,1719,644214,58836,703050,c6de539879adc31fba02bec7beeeacca8345316a
20200708,56,3042503,34363314,2360,43078,253534,5874,11303,2172,1103,953420,2020-07-08T07:00:00Z,124628,253534,2020-07-08T07:00:00Z,37408177,37405817,37405817,807,2035,566955,62147,629102,61a97fecf28eefab3d3dae7ffd2ffc3baa364954
20200707,56,2980356,33796359,2136,41760,251499,5832,11177,2098,1084,936476,2020-07-07T07:00:00Z,123821,251499,2020-07-07T07:00:00Z,36778851,36776715,36776715,923,1960,583025,51766,634791,c2d4427143df15b1bfe1f21acc4cb3154fddd49c
20200706,56,2928590,33213334,1907,39768,249539,5684,11058,2105,1070,924148,2020-07-06T07:00:00Z,122898,249539,2020-07-06T07:00:00Z,36143831,36141924,36141924,243,794,459601,41600,501201,baeef35b6a1efef997189b8adbf8a24efd186757
20200705,56,2886990,32753733,1885,38764,248745,5653,11010,2080,1064,902558,2020-07-05T07:00:00Z,122655,248745,2020-07-05T07:00:00Z,35642608,35640723,35640723,209,590,635661,45789,681450,0e331ad8669524af7f2d8412dff47e491aeca9c6
20200704,56,2841201,32118072,2083,38146,248155,5633,10977,1982,1063,894325,2020-07-04T07:00:00Z,122446,248155,2020-07-04T07:00:00Z,34961356,34959273,34959273,306,871,587437,54734,642171,50a57fa6fe8341b7430ad7f0b66704f07156d440
20200703,56,2786467,31530635,2237,37798,247284,5597,10936,2049,1059,883561,2020-07-03T07:00:00Z,122140,247284,2020-07-03T07:00:00Z,34319339,34317102,34317102,598,1435,656726,54223,710949,2b3473ad1955e34673fea1dbdfb1be624a104414
20200702,56,2732244,30873909,2208,37500,245849,5626,10843,2105,1041,875127,2020-07-02T07:00:00Z,121542,245849,2020-07-02T07:00:00Z,33608361,33606153,33606153,695,2003,608490,53826,662316,06ee58bbc2aa29fe6ba96931b1818120385bf7e1
20200701,56,2678418,30265419,2604,36405,243846,5512,10752,2098,1027,823151,2020-07-01T07:00:00Z,120847,243846,2020-07-01T07:00:00Z,32946441,32943837,32943837,701,1438,582612,50674,633286,b9b58c397caeba29cad1680bde360b5ceaf44fe9
20200630,56,2627744,29682807,2432,35248,242408,5424,10669,2044,1008,813788,2020-06-30T07:00:00Z,120146,242408,2020-06-30T07:00:00Z,32312983,32310551,32310551,596,1582,576601,47462,624063,81fa9bab32653ef8bf2b31c96445742c4eac65f8
20200629,56,2580282,29106206,2194,33586,240826,5380,10542,2011,990,798360,2020-06-29T07:00:00Z,119550,240826,2020-06-29T07:00:00Z,31688682,31686488,31686488,332,670,607649,39175,646824,4aedba3c9ddf840a600661a3cd0b82b3691bdc4a
20200628,56,2541107,28498557,2198,32476,240156,5248,10473,2077,983,778321,2020-06-28T07:00:00Z,119218,240156,2020-06-28T07:00:00Z,31041862,31039664,31039664,271,580,542041,41857,583898,2954058cc3af29f4e20dadae5eee76586e4472e3
20200627,56,2499250,27956516,2186,32483,239576,5315,10415,2159,977,772465,2020-06-27T07:00:00Z,118947,239576,2020-06-27T07:00:00Z,30457952,30455766,30455766,511,1057,555603,43783,599386,9fd061d3ed460a07423a80b4e3154436c755dd1f
20200626,56,2455467,27400913,2201,31738,238519,5283,10334,2075,966,763966,2020-06-26T07:00:00Z,118436,238519,2020-06-26T07:00:00Z,29858581,29856380,29856380,637,1526,562326,44421,606747,db81279e8a115a0228926f7944164af3cc639887
20200625,56,2411046,26838587,2133,31844,236993,5319,10257,2214,951,756719,2020-06-25T07:00:00Z,117799,236993,2020-06-25T07:00:00Z,29251766,29249633,29249633,647,1257,598076,39072,637148,889e1699019012ab60859f89a1a05dd48ae79901
20200624,56,2371974,26240511,2049,31102,235736,5293,10173,2248,934,747565,2020-06-24T07:00:00Z,117152,235736,2020-06-24T07:00:00Z,28614534,28612485,28612485,724,1310,480518,38684,519202,c8eacc3b9d0c254fd2d4bf4f7bb75dff23de2eeb
20200623,56,2333290,25759993,1891,30235,234426,5402,10077,2293,918,738952,2020-06-23T07:00:00Z,116428,234426,2020-06-23T07:00:00Z,28095174,28093283,28093283,710,1257,458698,33021,491719,7de0956af43927e036e86a9c42a13344306df0ed
20200622,56,2300269,25301295,2028,28799,233169,5323,10002,2299,909,731602,2020-06-22T07:00:00Z,115718,233169,2020-06-22T07:00:00Z,27603592,27601564,27601564,286,800,439588,27017,466605,daf8d89521c662025b3c9c0f6df51253dfb1a96b
20200621,56,2273252,24861707,2084,28219,232369,5195,9944,2321,904,713537,2020-06-21T07:00:00Z,115432,232369,2020-06-21T07:00:00Z,27137043,27134959,27134959,294,514,483814,27284,511098,92522816944ce7979b94e7bd3ee4a058a63b1121
20200620,56,2245968,24377893,2108,27967,231855,5229,9908,2380,888,708864,2020-06-20T07:00:00Z,115138,231855,2020-06-20T07:00:00Z,26625969,26623861,26623861,629,745,527221,31994,559215,ceac50d54065b29c5bcfa179ca1b92657a3c10da
20200619,56,2213974,23850672,2032,28615,231110,5341,9876,2434,884,698119,2020-06-19T07:00:00Z,114509,231110,2020-06-19T07:00:00Z,26066678,26064646,26064646,655,1613,542946,31046,573992,d010cde7052a958a8bc38ddb01548184792ebea9
20200618,56,2182928,23307726,1903,28414,229497,5465,9736,2520,869,690692,2020-06-18T07:00:00Z,113854,229497,2020-06-18T07:00:00Z,25492557,25490654,25490654,705,1040,488666,27527,516193,6c317c6426d13cf6899a85e166c7e42976d3dd5a
20200617,56,2155401,22819060,1745,28573,228457,5613,9665,2588,857,680916,2020-06-17T07:00:00Z,113149,228457,2020-06-17T07:00:00Z,24976206,24974461,24974461,767,1130,461417,23873,485290,20607adf34ee0c6605c090c1f9bf9a87ee17a597
20200616,56,2131528,22357643,1604,28270,227327,5570,9590,2594,845,672228,2020-06-16T07:00:00Z,112382,227327,2020-06-16T07:00:00Z,24490775,24489171,24489171,731,1301,441094,23435,464529,acc60532e0cd445070e3ecabde833594ff2ca3ca
20200615,56,2108093,21916549,1619,27867,226026,5703,9516,2640,835,665059,2020-06-15T07:00:00Z,111651,226026,2020-06-15T07:00:00Z,24026261,24024642,24024642,381,543,414301,18510,432811,9c74c8b6521dcc735db391db0118472c6b66beb5
20200614,56,2089583,21502248,1672,27893,225483,5749,9466,2716,834,650541,2020-06-14T07:00:00Z,111270,225483,2020-06-14T07:00:00Z,23593503,23591831,23591831,356,640,463847,21373,485220,707837a86285dfde126875689a29b52a681272a8
20200613,56,2068210,21038401,1698,28450,224843,5883,9430,2726,830,645331,2020-06-13T07:00:00Z,110914,224843,2020-06-13T07:00:00Z,23108309,23106611,23106611,694,1105,471087,25341,496428,795c272b9c730dac45b2b0ea69fab750de28d78a
20200612,56,2042869,20567314,1783,29154,223738,6017,9373,2734,814,636111,2020-06-12T07:00:00Z,110220,223738,2020-06-12T07:00:00Z,22611966,22610183,22610183,776,1245,599648,23477,623125,886696bbc927afd9afc6fec59be3b3e75a11e25b
20200611,56,2019392,19967666,1816,29698,222493,6074,9295,2886,792,629017,2020-06-11T07:00:00Z,109444,222493,2020-06-11T07:00:00Z,21988874,21987058,21987058,899,1367,437423,22032,459455,de717974e1372e5686c5c5a648f8e09d0e92ddf5
20200610,56,1997360,19530243,1737,30864,221126,6249,9225,3020,780,618125,2020-06-10T07:00:00Z,108545,221126,2020-06-10T07:00:00Z,21529340,21527603,21527603,887,1484,408196,20803,428999,94ef6dc2f48941e5927401ff70831206f00bc0c9
20200609,56,1976557,19122047,1661,31183,219642,6457,9141,3090,771,609476,2020-06-09T07:00:00Z,107658,219642,2020-06-09T07:00:00Z,21100265,21098604,21098604,902,1527,402549,17175,419724,ec8cda35e49e2e81e386efe6bdffc923a6d97b9d
20200608,56,1959382,18719498,1606,31202,218115,6402,9013,3240,762,603143,2020-06-08T07:00:00Z,106756,218115,2020-06-08T07:00:00Z,20680486,20678880,20678880,661,714,378134,17012,395146,09f3662b3185e847b4905439871632ebb5d5526f
20200607,56,1942370,18341364,1733,31408,217401,6501,8957,3298,753,590988,2020-06-07T07:00:00Z,106095,217401,2020-06-07T07:00:00Z,20285467,20283734,20283734,447,685,403548,18823,422371,39c59fd0b71ebbbc4244886c5c75d7c98d7775f5
20200606,56,1923547,17937816,1796,31938,216716,6762,8920,3476,750,585470,2020-06-06T07:00:00Z,105648,216716,2020-06-06T07:00:00Z,19863159,19861363,19861363,728,1017,520713,23106,543819,c0998db8de633a772db029ec74902ea27ef31603
20200605,56,1900441,17417103,1749,32451,215699,6920,8863,3523,740,576327,2020-06-05T07:00:00Z,104920,215699,2020-06-05T07:00:00Z,19319293,19317544,19317544,826,1440,482923,23352,506275,914ee358d4d1a5421ccaee04725daef4a3559ec2
20200604,56,1877089,16934180,3474,32835,214259,7057,8787,3665,723,569623,2020-06-04T07:00:00Z,104094,214259,2020-06-04T07:00:00Z,18814743,18811269,18811269,893,-2841,440145,20839,460984,c5ac73eeb26b64ee68d5c5d7a70aa15b3e73e03b
20200603,56,1856250,16494035,3556,33269,217100,7227,8688,3749,717,557366,2020-06-03T07:00:00Z,103201,217100,2020-06-03T07:00:00Z,18353841,18350285,18350285,993,2255,446402,20312,466714,c7f5bef26bb1fceb07d1cee22d8160747c8a415c
20200602,56,1835938,16047633,4054,33933,214845,7407,8566,3852,710,541976,2020-06-02T07:00:00Z,102208,214845,2020-06-02T07:00:00Z,17887625,17883571,17883571,963,1585,398664,19982,418646,2abe27bd141a4498224e5e66fd6d1b157f30f95e
20200601,56,1815956,15648969,3455,34285,213260,7591,8485,3950,704,536339,2020-06-01T07:00:00Z,101245,213260,2020-06-01T07:00:00Z,17468380,17464925,17464925,669,2796,391912,20415,412327,9917115f55782fa719398a613e993f43ba357029
20200531,56,1795541,15257057,3270,34859,210464,7626,8445,3669,704,522866,2020-05-31T07:00:00Z,100576,210464,2020-05-31T07:00:00Z,17055868,17052598,17052598,653,976,374532,21639,396171,68b2e27027e6ab2526094b17b4ea79815ec27e91
20200530,56,1773902,14882525,1668,35732,209488,7956,8305,4004,698,494569,2020-05-30T07:00:00Z,99923,209488,2020-05-30T07:00:00Z,16658095,16656427,16656427,932,1424,401992,23762,425754,1a4cbd0277d2414379159e434e531020db4d8cc1
20200529,56,1750140,14480533,2978,36999,208064,8175,8235,4032,689,484554,2020-05-29T07:00:00Z,98991,208064,2020-05-29T07:00:00Z,16233651,16230673,16230673,1184,1715,463707,23522,487229,c8ddfef0435e9cd8c2c33c9845e2c66b62de14c5
20200528,56,1726618,14016826,1906,38069,206349,8389,8109,4080,676,478099,2020-05-28T07:00:00Z,97807,206349,2020-05-28T07:00:00Z,15745350,15743444,15743444,1231,1630,411869,22601,434470,81cd78e65b22bad1648a5cf57ff4969da196bbf2
20200527,56,1704017,13604957,3132,38373,204719,8547,8015,4222,666,391508,2020-05-27T07:00:00Z,96576,204719,2020-05-27T07:00:00Z,15312106,15308974,15308974,1322,1713,289048,19385,308433,917dcb026ab1090418b3ea913bbdc05442c135eb
20200526,56,1684632,13315909,1549,37779,203006,8585,7899,4215,650,384902,2020-05-26T07:00:00Z,95254,203006,2020-05-26T07:00:00Z,15002090,15000541,15000541,646,17320,289303,16629,305932,8ccb11b5402788767e54a35f30bff6f07c1daad6
20200525,56,1668003,13026606,3368,37650,185686,8472,7847,4237,642,379157,2020-05-25T07:00:00Z,94608,185686,2020-05-25T07:00:00Z,14697977,14694609,14694609,560,1002,403790,18798,422588,25557bda012d672a930509915dd770f2c6f411dd
20200524,56,1649205,12622816,3860,37695,184684,8487,7801,4383,639,366736,2020-05-24T07:00:00Z,94048,184684,2020-05-24T07:00:00Z,14275881,14272021,14272021,680,921,361400,20105,381505,1855de72d81fc4dd7be50d650f226f982026f871
20200523,56,1629100,12261416,4084,38614,183763,8733,7770,4620,638,361239,2020-05-23T07:00:00Z,93368,183763,2020-05-23T07:00:00Z,13894600,13890516,13890516,1063,1378,368410,21590,390000,1a4add71a4f7911e71149400c8ee2747420aa196
20200522,56,1607510,11893006,3709,39989,182385,9048,7689,4716,633,350135,2020-05-22T07:00:00Z,92305,182385,2020-05-22T07:00:00Z,13504225,13500516,13500516,1342,4046,384533,24555,409088,b94d24dcf21869333e57c1a9541d182f92c57ef2
20200521,56,1582955,11508473,3641,41191,178339,9090,7412,4868,616,298418,2020-05-21T07:00:00Z,90963,178339,2020-05-21T07:00:00Z,13095069,13091428,13091428,1394,4630,435306,26513,461819,1eeaa1e75c0d1dd13557c789c792518d81276286
20200520,56,1556442,11073167,2973,41762,173709,9522,7319,4911,613,294312,2020-05-20T07:00:00Z,89569,173709,2020-05-20T07:00:00Z,12632582,12629609,12629609,1401,1996,385840,21319,407159,3008cd90ea6775d1ff8168989f278d52a8077f06
20200519,56,1535123,10687327,2944,41872,171713,9597,7217,5032,606,289484,2020-05-19T07:00:00Z,88168,171713,2020-05-19T07:00:00Z,12225394,12222450,12222450,1326,1597,380486,20853,401339,da0eaa91678b8fa8bff199efbba0fae63f07835a
20200518,56,1514270,10306841,3596,41748,170116,9755,7064,5257,602,283178,2020-05-18T07:00:00Z,86842,170116,2020-05-18T07:00:00Z,11824707,11821111,11821111,850,1157,333721,20992,354713,f6f13b0cbed0f1be15a0173360b084bc74ed093e
20200517,56,1493278,9973120,3449,41785,168959,9932,7003,5467,593,272265,2020-05-17T07:00:00Z,85992,168959,2020-05-17T07:00:00Z,11469847,11466398,11466398,849,1199,350983,20171,371154,ec495177cbb1ca0e647a08275be19cbb95dca2d6
20200516,56,1473107,9622137,3788,43396,167760,10277,6945,5529,592,268376,2020-05-16T07:00:00Z,85143,167760,2020-05-16T07:00:00Z,11099032,11095244,11095244,989,1856,337419,24701,362120,0684ea0ea62925f209598957eac240b310ef9fb3
20200515,56,1448406,9284718,2457,44491,165904,10472,6890,5746,589,250747,2020-05-15T07:00:00Z,84154,165904,2020-05-15T07:00:00Z,10735581,10733124,10733124,1507,1353,333613,24710,358323,066f6b13105204e3bd12f5c323a21eaa776ba5e2
20200514,56,1423696,8951105,2673,45790,164551,10656,6795,5940,582,246414,2020-05-14T07:00:00Z,82647,164551,2020-05-14T07:00:00Z,10377474,10374801,10374801,1880,3206,337369,26705,364074,0ef28d3f8ea96bb52a5f7151d3eee636af079780
20200513,56,1396991,8613736,1983,46926,161345,10978,6713,6156,572,243430,2020-05-13T07:00:00Z,80767,161345,2020-05-13T07:00:00Z,10012710,10010727,10010727,1705,1809,297848,21193,319041,9a1eb55319ca805d853ac139e21dce0f11c79c99
20200512,56,1375798,8315888,1803,47596,159536,11241,5595,6352,559,238857,2020-05-12T07:00:00Z,79062,159536,2020-05-12T07:00:00Z,9693489,9691686,9691686,1486,1579,285892,22663,308555,b49cfc7008df799e4bdaa8cddfff6ad1eb82c31e
20200511,56,1353135,8029996,1989,46552,157957,11147,6488,6350,551,232142,2020-05-11T07:00:00Z,77576,157957,2020-05-11T07:00:00Z,9385120,9383131,9383131,893,1238,363887,18236,382123,8c6e1a4f92afe75281e69d1c44b96ea3c3adec59
20200510,56,1334899,7666109,3095,47163,156719,11393,6445,6395,547,215591,2020-05-10T07:00:00Z,76683,156719,2020-05-10T07:00:00Z,9004103,9001008,9001008,1038,1055,244826,21504,266330,2a5ac3682096b4a9af2719f59e1cb48a9d598580
20200509,56,1313395,7421283,3054,48768,155664,11496,6367,6551,543,211976,2020-05-09T07:00:00Z,75645,155664,2020-05-09T07:00:00Z,8737732,8734678,8734678,1446,1708,266799,24810,291609,6d8f4e99924ae94b3586879cbd85678748ff35e4
20200508,56,1288585,7154484,3307,49992,153956,11780,6294,6788,531,198459,2020-05-08T07:00:00Z,74199,153956,2020-05-08T07:00:00Z,8446376,8443069,8443069,1800,6892,270245,27605,297850,0682845066ff2c21958162726c690df95c7b9c5e
20200507,56,1260980,6884239,3171,51683,147064,12137,5174,7070,529,194528,2020-05-07T07:00:00Z,72399,147064,2020-05-07T07:00:00Z,8148390,8145219,8145219,2754,3742,274154,27490,301644,d0a7d460d5c74a966bb12520b67dc18e68933efa
20200506,56,1233490,6610085,2742,52773,143322,12478,4911,4753,449,189425,2020-05-06T07:00:00Z,69645,143322,2020-05-06T07:00:00Z,7846317,7843575,7843575,1951,2119,219777,25056,244833,3cfb0bd352adfe474e2c614f5cc21ef5b0bc14d2
20200505,56,1208434,6390308,2633,53455,141203,12629,4794,4818,439,189336,2020-05-05T07:00:00Z,67694,141203,2020-05-05T07:00:00Z,7601375,7598742,7598742,2455,1983,249022,22449,271471,9e8bb2bdd7fb065993bb5f0381c298ac99268665
20200504,56,1185985,6141286,2791,52634,139220,12696,4579,4848,430,186752,2020-05-04T07:00:00Z,65239,139220,2020-05-04T07:00:00Z,7330062,7327271,7327271,1036,1651,208933,22523,231456,fe6f8f44a85c0b820d65d29cc6388c6166ea9c69
20200503,56,1163462,5932353,2812,52857,137569,12722,4502,4761,425,179733,2020-05-03T07:00:00Z,64203,137569,2020-05-03T07:00:00Z,7098627,7095815,7095815,1231,1963,210747,25767,236514,cfb61a456a3e5a2f7e451deddcec59fe2f5a3615
20200502,56,1137695,5721606,1578,54278,135606,12904,4386,4845,375,174987,2020-05-02T07:00:00Z,62972,135606,2020-05-02T07:00:00Z,6860879,6859301,6859301,1565,2031,217899,29185,247084,24c63ec3aca97ad1386616447ac91fdfb7969e5c
20200501,56,1108510,5503707,1639,55122,133575,12845,4300,4707,376,163644,2020-05-01T07:00:00Z,61407,133575,2020-05-01T07:00:00Z,6613856,6612217,6612217,1778,9789,262170,33056,295226,6ff960d7846c9939717765800027ca7edeacf88b
20200430,56,1075454,5241537,2775,55114,123786,13255,4192,4712,373,154648,2020-04-30T07:00:00Z,59629,123786,2020-04-30T07:00:00Z,6319766,6316991,6316991,2142,2290,203240,29568,232808,8b32a173a467a2b0f34479fe86f286f86e25d612
20200429,56,1045886,5038297,4832,56206,121496,13535,4093,4796,365,147165,2020-04-29T07:00:00Z,57487,121496,2020-04-29T07:00:00Z,6089015,6084183,6084183,2713,3415,211964,26641,238605,9b73d56f12c802c7b0f1c6813db965474e5b59db
20200428,56,1019245,4826333,4206,56255,118081,13562,3798,4760,195,139041,2020-04-28T07:00:00Z,54774,118081,2020-04-28T07:00:00Z,5849784,5845578,5845578,2074,2079,181395,25219,206614,5f33c0c5ea32058dfe1eaf8036c9cbd9a9ee7c2d
20200427,56,994026,4644938,4077,56191,116002,13812,3720,4867,195,121323,2020-04-27T07:00:00Z,52700,116002,2020-04-27T07:00:00Z,5643041,5638964,5638964,1274,3076,172795,22605,195400,4b5bb472f6d1c2bfd573cffdd0be6abf4aef7998
20200426,56,971421,4472143,4445,56186,112926,14099,2571,5121,227,116529,2020-04-26T07:00:00Z,51426,112926,2020-04-26T07:00:00Z,5448009,5443564,5443564,1219,2192,178908,27380,206288,1d18c0e4dbf4642a3a511767c2fc2d888a9183b9
20200425,56,944041,4293235,5315,57377,110734,14414,2516,5266,227,112539,2020-04-25T07:00:00Z,50207,110734,2020-04-25T07:00:00Z,5242591,5237276,5237276,1752,2456,240249,35901,276150,564ec1c6e6d00c57fa847bbc44cd0f091aaccf45
20200424,56,908140,4052986,4396,57300,108278,14602,2468,5187,227,101296,2020-04-24T07:00:00Z,48455,108278,2020-04-24T07:00:00Z,4965522,4961126,4961126,1897,2338,201683,34174,235857,f14c3375e87379f60fa7d0bf346209ec7abe3f94
20200423,56,873966,3851303,4258,58989,105940,14744,2428,5464,227,96921,2020-04-23T07:00:00Z,46558,105940,2020-04-23T07:00:00Z,4729527,4725269,4725269,1794,2802,161026,31784,192810,4a0e8d0551aff3b79796851bd33432c53ec65d0b
20200422,56,842182,3690277,4191,59205,103138,15015,2370,5474,227,92978,2020-04-22T07:00:00Z,44764,103138,2020-04-22T07:00:00Z,4536650,4532459,4532459,2098,3087,294567,28916,323483,e0e14a5d3562f6564742a4fd6fa8437cb1a2d6ee
20200421,56,813266,3395710,3956,59780,100051,14941,2315,5514,214,72842,2020-04-21T07:00:00Z,42666,100051,2020-04-21T07:00:00Z,4212932,4208976,4208976,2467,2682,126501,26333,152834,4f4376649c45fea9d3930ad4c89609e31534abde
20200420,56,786933,3269209,4037,56783,97369,14489,2193,5567,214,69493,2020-04-20T07:00:00Z,40199,97369,2020-04-20T07:00:00Z,4060179,4056142,4056142,1801,2211,119816,25872,145688,87a7c6b9b504a19b840ed9e7da1ade82372c1660
20200419,56,761061,3149393,11324,56526,95158,14410,2145,5603,214,67205,2020-04-19T07:00:00Z,38398,95158,2020-04-19T07:00:00Z,3921778,3910454,3910454,1773,2239,126462,27468,153930,6919d55c77e5f0e32d2a393534e78116809c2056
20200418,56,733593,3022931,9906,57761,92919,14768,2096,5729,205,62840,2020-04-18T07:00:00Z,36625,92919,2020-04-18T07:00:00Z,3766430,3756524,3756524,1893,3563,117871,27963,145834,a51b3bf9efec6ff8641d9011d083565fb2b88af0
20200417,56,705630,2905060,10889,58895,89356,14890,2052,6096,148,53533,2020-04-17T07:00:00Z,34732,89356,2020-04-17T07:00:00Z,3621579,3610690,3610690,2123,3405,126720,31964,158684,feacbc18fcbec5767b2eb2e6358cc666549f6a62
20200416,56,673666,2778340,16927,59499,85951,15130,1834,5940,137,48851,2020-04-16T07:00:00Z,32609,85951,2020-04-16T07:00:00Z,3468933,3452006,3452006,2202,3071,132875,30923,163798,91202670c942a831ef94df6423039eeec45ab289
20200415,56,642743,2645465,16901,59940,82880,14647,1783,6032,223,43435,2020-04-15T07:00:00Z,30407,82880,2020-04-15T07:00:00Z,3305109,3288208,3288208,2545,4434,106684,30298,136982,d9f75720c0578eb86d8e07474e55efbaf5cd6c94
20200414,56,612445,2538781,16615,59601,78446,14039,1715,5975,221,39268,2020-04-14T07:00:00Z,27862,78446,2020-04-14T07:00:00Z,3167841,3151226,3151226,2340,3282,126141,25631,151772,268e6b529a408ae4eef971441a991fea6fb87cb1
20200413,56,586814,2412640,17159,56195,75164,13632,1628,6168,210,35372,2020-04-13T07:00:00Z,25522,75164,2020-04-13T07:00:00Z,3016613,2999454,2999454,1646,4285,109050,25133,134183,04e8e0df74844364b58a3e20cc4b500689688479
20200412,56,561681,2303590,16419,55426,70879,13623,1455,5986,160,34081,2020-04-12T07:00:00Z,23876,70879,2020-04-12T07:00:00Z,2881690,2865271,2865271,1705,3288,111073,27844,138917,4bdcbab6c14a780433dba1ed9be900e37c510611
20200411,56,533837,2192517,16593,55572,67591,13280,1405,5978,154,31567,2020-04-11T07:00:00Z,22171,67591,2020-04-11T07:00:00Z,2742947,2726354,2726354,2056,2825,106426,30561,136987,cfb85e396c70348f315b71b51701bd6c626b01fb
20200410,56,503276,2086091,17435,52723,64766,12698,1185,5937,41,28997,2020-04-10T07:00:00Z,20115,64766,2020-04-10T07:00:00Z,2606802,2589367,2589367,2111,4934,124042,34351,158393,82e9fc45f29a3ef94349721c757ebe358bd6b9ea
20200409,56,468925,1962049,17622,50859,59832,12254,924,5794,39,24819,2020-04-09T07:00:00Z,18004,59832,2020-04-09T07:00:00Z,2448596,2430974,2430974,2043,3923,136639,34419,171058,5ca3641af82460492482f3218c70ec91257645fc
20200408,56,434506,1825410,17219,45141,55909,10180,1013,4131,216,21102,2020-04-08T07:00:00Z,15961,55909,2020-04-08T07:00:00Z,2277135,2259916,2259916,2013,4311,116954,30534,147488,f4cf1089ac6d473462ec20f81d2583f3f1a2ef63
20200407,56,403972,1708456,16548,43465,51598,9821,889,4076,151,18443,2020-04-07T07:00:00Z,13948,51598,2020-04-07T07:00:00Z,2128976,2112428,2112428,2023,2981,123505,30737,154242,4a82a6e55791dadb4da0ff72d705788ca09d6ac3
20200406,56,373235,1584951,17283,35856,48617,6943,814,2961,147,16554,2020-04-06T07:00:00Z,11925,48617,2020-04-06T07:00:00Z,1975469,1958186,1958186,1320,2946,123071,28937,152008,b7a41d1199a051d4a662ec46e617ef5fb3433e62
20200405,56,344298,1461880,17303,31875,45671,5677,760,652,147,14513,2020-04-05T07:00:00Z,10605,45671,2020-04-05T07:00:00Z,1823481,1806178,1806178,1340,3903,94105,25550,119655,9be607ab1c7c5d599a03972474d8947d5e03aef1
20200404,56,318748,1367775,15569,29987,41768,5383,554,656,147,12816,2020-04-04T07:00:00Z,9265,41768,2020-04-04T07:00:00Z,1702092,1686523,1686523,1482,5086,195941,33252,229193,7674db5811b4a23f2af50a5c8cfc1bb52be3d68c
20200403,56,285496,1171834,61976,25472,36682,4811,486,605,147,10861,2020-04-03T07:00:00Z,7783,36682,2020-04-03T07:00:00Z,1519306,1457330,1457330,1286,4554,100945,31945,132890,7ee238c6758634df4d17144bcf2de21a3c5eac82
20200402,56,253551,1070889,62097,22764,32128,4410,456,574,140,8586,2020-04-02T07:00:00Z,6497,32128,2020-04-02T07:00:00Z,1386537,1324440,1324440,1172,4175,90859,27992,118851,97f1fa61fa68544781d23f6ed52e0bdb015c87fb
20200401,56,225559,980030,59665,20775,27953,3937,407,561,140,7084,2020-04-01T07:00:00Z,5325,27953,2020-04-01T07:00:00Z,1265254,1205589,1205589,1010,4228,82748,25773,108521,0602ae02c4bee3bb92ecc21115d6b16679eb5183
20200331,56,199786,897282,59518,18082,23725,3487,236,507,,5666,2020-03-31T07:00:00Z,4315,23725,2020-03-31T07:00:00Z,1156586,1097068,1097068,890,3906,87636,24694,112330,bc2135b77610119bd80d4d7fdf28cbfb699ad501
20200330,56,175092,809646,65369,15772,19819,3087,187,451,,4560,2020-03-30T07:00:00Z,3425,19819,2020-03-30T07:00:00Z,1050107,984738,984738,589,2536,96564,21897,118461,df6dbb5dab0cecc4c672315aa375e299b8b53251
20200329,56,153195,713082,65545,14026,17283,2456,156,439,,4052,2020-03-29T07:00:00Z,2836,17283,2020-03-29T07:00:00Z,931822,866277,866277,522,2775,67957,19655,87612,8d505e95a0b6df0f7cde51a8003256823e596697
20200328,56,133540,645125,65709,12350,14508,2174,140,390,,3143,2020-03-28T07:00:00Z,2314,14508,2020-03-28T07:00:00Z,844374,778665,778665,538,2425,87146,19724,106870,470a951f115bc9ed1b3b318b11e92a79316650fa
20200327,56,113816,557979,60091,10932,12083,1792,124,324,,2418,2020-03-27T07:00:00Z,1776,12083,2020-03-27T07:00:00Z,731886,671795,671795,406,2563,83612,19044,102656,733103cbeb0560bebcf16af92b25aaa4c90c6c68
20200326,56,94772,474367,60251,7757,9520,1299,91,258,,97,2020-03-26T07:00:00Z,1370,9520,2020-03-26T07:00:00Z,629390,569139,569139,320,2499,84159,17656,101815,8936e674e57e95a40f575b545e2ba4f7a0a2d915
20200325,56,77116,390208,51235,5062,7021,,74,167,,146,2020-03-25T07:00:00Z,1050,7021,2020-03-25T07:00:00Z,518559,467324,467324,235,1904,71521,12873,84394,cb3f531756e14c69576cf0a007e37c7920e2348a
20200324,56,64243,318687,14433,3902,5117,,,,,,2020-03-24T07:00:00Z,815,5117,2020-03-24T07:00:00Z,397363,382930,382930,234,1180,58505,10632,69137,8cb0b43f04471b5dd5df7cd53fbfcfee00844eaf
20200323,56,53611,260182,14571,2770,3937,,,,,,2020-03-23T07:00:00Z,581,3937,2020-03-23T07:00:00Z,328364,313793,313793,101,914,46706,11442,58148,c59225e89a125f4067b59dadc6e63c2d4d4d832d
20200322,56,42169,213476,2842,2155,3023,,,,,,2020-03-22T07:00:00Z,480,3023,2020-03-22T07:00:00Z,258487,255645,255645,146,1003,36214,9259,45473,81aeb9b3bc8867a11d07e69c756d7e9e3442290b
20200321,56,32910,177262,3468,1436,2020,,,,,,2020-03-21T07:00:00Z,334,2020,2020-03-21T07:00:00Z,213640,210172,210172,62,1912,38448,6885,45333,a41b67f3796371f36042079fd6605fa0fb9ba7fd
20200320,56,26025,138814,3330,1042,108,,,,,,2020-03-20T07:00:00Z,272,108,2020-03-20T07:00:00Z,168169,164839,164839,69,23,30407,6255,36662,5aebdcf86ef2e05b3b2a6ce4360054627758c208
20200319,56,19770,108407,3016,617,85,,,,,,2020-03-19T07:00:00Z,203,85,2020-03-19T07:00:00Z,131193,128177,128177,48,18,23410,4671,28081,ad7924911e70f2dee0f11b6094a2b91c4e0bad3d
20200318,56,15099,84997,2526,416,67,,,,,,2020-03-18T07:00:00Z,155,67,2020-03-18T07:00:00Z,102622,100096,100096,32,12,21893,3171,25064,442592af49861a78e2dd189a11beca498f867b4d
20200317,56,11928,63104,1687,325,55,,,,,,2020-03-17T07:00:00Z,123,55,2020-03-17T07:00:00Z,76719,75032,75032,23,13,13707,3613,17320,26f3d8cf66971af2c079d2760a5959bc96d7f2ef
20200316,56,8315,49397,1691,,42,,,,,,2020-03-16T07:00:00Z,100,42,2020-03-16T07:00:00Z,59403,57712,57712,21,6,16355,1569,17924,f7f9a04c825c37c27e2daf26be9c3e15cd70aff4
20200315,51,6746,33042,2242,,36,,,,,,2020-03-15T07:00:00Z,79,36,2020-03-15T07:00:00Z,42030,39788,39788,15,10,6353,1251,7604,7c8f33c61da4b8216beaf46cfc20ad6133c73fb9
20200314,51,5495,26689,1236,,26,,,,,,2020-03-14T07:00:00Z,64,26,2020-03-14T07:00:00Z,33420,32184,32184,9,4,3695,915,4610,49794fea7cae7e9ef446a3e4a1ace74fcb516bdb
20200313,51,4580,22994,1130,,22,,,,,,2020-03-13T07:00:00Z,55,22,2020-03-13T07:00:00Z,28704,27574,27574,4,6,8146,1025,9171,ac653afb7a131b8662d182827e14ec0a34d24c80
20200312,51,3555,14848,673,,16,,,,,,2020-03-12T07:00:00Z,51,16,2020-03-12T07:00:00Z,19076,18403,18403,8,5,4628,682,5310,347184b6b83a2ebc87f675e23758d82b19985808
20200311,50,2873,10220,563,,11,,,,,,2020-03-11T07:00:00Z,43,11,2020-03-11T07:00:00Z,13656,13093,13093,6,3,3291,527,3818,642a311f43c0d67cd05374e5bda8062d39b6f8ba
20200310,50,2346,6929,469,,8,,,,,,2020-03-10T07:00:00Z,37,8,2020-03-10T07:00:00Z,9744,9275,9275,2,0,2049,441,2490,76ed75a8512358686ab1b35cb906c07f0745a372
20200309,50,1905,4880,313,,8,,,,,,2020-03-09T07:00:00Z,35,8,2020-03-09T07:00:00Z,7098,6785,6785,4,2,1406,367,1773,a408bd1c203bc27e7860ae8a3ad671e4a47b62a0
20200308,50,1538,3474,347,,6,,,,,,2020-03-08T08:00:00Z,31,6,2020-03-08T08:00:00Z,5359,5012,5012,4,0,607,267,874,879bfe36142ae8476d8ead5f5e7c495a88d83e82
20200307,50,1271,2867,602,,6,,,,,,2020-03-07T08:00:00Z,27,6,2020-03-07T08:00:00Z,4740,4138,4138,1,0,578,220,798,50b2401d476500413f7584bc2f95dd1e27ebacf1
20200306,36,1051,2289,458,,6,,,,,,2020-03-06T08:00:00Z,26,6,2020-03-06T08:00:00Z,3798,3340,3340,6,1,645,141,786,4d09e9a612bd0dec779b942fc72f3ceb821f8695
20200305,24,910,1644,197,,5,,,,,,2020-03-05T08:00:00Z,20,5,2020-03-05T08:00:00Z,2751,2554,2554,4,1,464,153,617,35a06a125142c33ec9528df55cf758c118bf7bb0
20200304,15,757,1180,103,,4,,,,,,2020-03-04T08:00:00Z,16,4,2020-03-04T08:00:00Z,2040,1937,1937,2,4,911,187,1098,392603b01906e52429923582c5ef0c6f2d84fe64
20200303,3,570,269,,,,,,,,,2020-03-03T08:00:00Z,14,,2020-03-03T08:00:00Z,839,839,839,3,0,143,100,243,6ba0790cc86485eb6a980e2ecf71a568f679ff54
20200302,3,470,126,,,,,,,,,2020-03-02T08:00:00Z,11,,2020-03-02T08:00:00Z,596,596,596,3,0,112,82,194,286507f1544430a5e6e9bade73bd8f6dfcf43163
20200301,3,388,14,,,,,,,,,2020-03-01T08:00:00Z,8,,2020-03-01T08:00:00Z,402,402,402,3,0,-3,89,86,3fbafbe2373d4b4df563a5057a551649e4b63ba2
20200229,1,299,17,,,,,,,,,2020-02-29T08:00:00Z,5,,2020-02-29T08:00:00Z,316,316,316,1,0,17,24,41,0ba89f048823058eac54819df9faaf81cbced9fb
20200228,1,275,0,,,,,,,,,2020-02-28T08:00:00Z,4,,2020-02-28T08:00:00Z,275,275,275,2,0,0,40,40,f6bc78658160a7ced0ff5bf99a0f15b9ec5abc60
20200227,1,235,0,,,,,,,,,2020-02-27T08:00:00Z,2,,2020-02-27T08:00:00Z,235,235,235,0,0,0,27,27,8861230e7ca079c4bce5dd40ce802b13e70969c5
20200226,1,208,0,,,,,,,,,2020-02-26T08:00:00Z,2,,2020-02-26T08:00:00Z,208,208,208,2,0,0,29,29,12aded282c784336fb007f2076f5c2eb7d46e86e
20200225,1,179,0,,,,,,,,,2020-02-25T08:00:00Z,,,2020-02-25T08:00:00Z,179,179,179,0,0,0,31,31,323694e34487b759bce045aab2eb02781f0390a1
20200224,1,148,0,,,,,,,,,2020-02-24T08:00:00Z,,,2020-02-24T08:00:00Z,148,148,148,0,0,0,26,26,f09741f8c095fab5c3886a9dae0fd496a051c0f3
20200223,1,122,0,,,,,,,,,2020-02-23T08:00:00Z,,,2020-02-23T08:00:00Z,122,122,122,0,0,0,16,16,000baa912f0bf9dca3d1fab4e52dad39f1f1ad44
20200222,1,106,0,,,,,,,,,2020-02-22T08:00:00Z,,,2020-02-22T08:00:00Z,106,106,106,0,0,0,13,13,bdf7b48d58fc03a47ed3caf564ada05beeb8d1da
20200221,1,93,0,,,,,,,,,2020-02-21T08:00:00Z,,,2020-02-21T08:00:00Z,93,93,93,0,0,0,11,11,51275a8313205ba6136cce3d7dd7074dcebf165c
20200220,1,82,0,,,,,,,,,2020-02-20T08:00:00Z,,,2020-02-20T08:00:00Z,82,82,82,0,0,0,13,13,43e119ca41e99a59ddc0478666a67d3cd54edb9c
20200219,1,69,0,,,,,,,,,2020-02-19T08:00:00Z,,,2020-02-19T08:00:00Z,69,69,69,0,0,0,10,10,0436e1825c9f938df70bde365e0a8475add0959b
20200218,1,59,0,,,,,,,,,2020-02-18T08:00:00Z,,,2020-02-18T08:00:00Z,59,59,59,0,0,0,9,9,b78ba8f5a0e23fa34d2301c0e62e759823d20f49
20200217,1,50,0,,,,,,,,,2020-02-17T08:00:00Z,,,2020-02-17T08:00:00Z,50,50,50,0,0,0,15,15,26b58ef6b5d31683635fe74bc1104d7e9a4451d7
20200216,1,35,0,,,,,,,,,2020-02-16T08:00:00Z,,,2020-02-16T08:00:00Z,35,35,35,0,0,0,7,7,56f3f76c669cc3d0cd6c62fa9ca1a0493eb4a505
20200215,1,28,0,,,,,,,,,2020-02-15T08:00:00Z,,,2020-02-15T08:00:00Z,28,28,28,0,0,0,7,7,bdf10c12ae418524604c460e10f31f7fedf0afcb
20200214,1,21,0,,,,,,,,,2020-02-14T08:00:00Z,,,2020-02-14T08:00:00Z,21,21,21,0,0,0,3,3,09d7819af3bdedad7aa2c56507885b50ed8784bf
20200213,1,18,0,,,,,,,,,2020-02-13T08:00:00Z,,,2020-02-13T08:00:00Z,18,18,18,0,0,0,0,0,edc238aa08648e17ac6e60fae803b63374428f51
20200212,1,18,0,,,,,,,,,2020-02-12T08:00:00Z,,,2020-02-12T08:00:00Z,18,18,18,0,0,0,1,1,505b0f426626ff76c7f2060404e39f97f6731cae
20200211,1,17,0,,,,,,,,,2020-02-11T08:00:00Z,,,2020-02-11T08:00:00Z,17,17,17,0,0,0,1,1,5a1f5d2a7ae228c4a76cc088b8b57fc041564d64
20200210,1,16,0,,,,,,,,,2020-02-10T08:00:00Z,,,2020-02-10T08:00:00Z,16,16,16,0,0,0,3,3,5ddc9e4d8825ac8a025d8c27e6ab2b76ef505e47
20200209,1,13,0,,,,,,,,,2020-02-09T08:00:00Z,,,2020-02-09T08:00:00Z,13,13,13,0,0,0,0,0,d97bed60ce8f2e721018ab4be35ea9ffb0e97053
20200208,1,13,0,,,,,,,,,2020-02-08T08:00:00Z,,,2020-02-08T08:00:00Z,13,13,13,0,0,0,1,1,af4301fb595fe2dc86b980d60406fb9a9efd2df3
20200207,1,12,0,,,,,,,,,2020-02-07T08:00:00Z,,,2020-02-07T08:00:00Z,12,12,12,0,0,0,1,1,9ccb09ac2f5a8ac4469e340bdb2e167ab6b6276e
20200206,1,11,0,,,,,,,,,2020-02-06T08:00:00Z,,,2020-02-06T08:00:00Z,11,11,11,0,0,0,3,3,1b62fe1e4125f590ae48f670f45b649409d7e1ae
20200205,1,8,0,,,,,,,,,2020-02-05T08:00:00Z,,,2020-02-05T08:00:00Z,8,8,8,0,0,0,0,0,2c7ad4036f95ca974e3423470c0691d4a1e5337d
20200204,1,8,0,,,,,,,,,2020-02-04T08:00:00Z,,,2020-02-04T08:00:00Z,8,8,8,0,0,0,1,1,d18f1238ed9712ecb71ad3a2a562ed7aeac36153
20200203,1,7,0,,,,,,,,,2020-02-03T08:00:00Z,,,2020-02-03T08:00:00Z,7,7,7,0,0,0,1,1,3e8b42cedc6b428d4694f46b5c9befe708d33f9e
20200202,1,6,0,,,,,,,,,2020-02-02T08:00:00Z,,,2020-02-02T08:00:00Z,6,6,6,0,0,0,2,2,ef8fcddb1f511fbafc58296dca2e0b1a001deefd
20200201,1,4,0,,,,,,,,,2020-02-01T08:00:00Z,,,2020-02-01T08:00:00Z,4,4,4,0,0,0,1,1,ba1a59bcf911de4bec149f30e33b40c7b27684ee
20200131,1,3,0,,,,,,,,,2020-01-31T08:00:00Z,,,2020-01-31T08:00:00Z,3,3,3,0,0,0,0,0,5489f02ef4f3104c7e183d61307290452e3ee547
20200130,1,3,0,,,,,,,,,2020-01-30T08:00:00Z,,,2020-01-30T08:00:00Z,3,3,3,0,0,0,0,0,c5200ee454b9232a68ed31f3bed0d133e34a8e55
20200129,1,3,0,,,,,,,,,2020-01-29T08:00:00Z,,,2020-01-29T08:00:00Z,3,3,3,0,0,0,1,1,2de92f3b9f56a7240baadf4e32119c96fc018511
20200128,1,2,0,,,,,,,,,2020-01-28T08:00:00Z,,,2020-01-28T08:00:00Z,2,2,2,0,0,0,0,0,6185bcb4f2f5a740399efff03af5e9851d483b9e
20200127,1,2,0,,,,,,,,,2020-01-27T08:00:00Z,,,2020-01-27T08:00:00Z,2,2,2,0,0,0,0,0,4aaee929bd09ae3df46a8838169ff3b6296ba3f4
20200126,1,2,0,,,,,,,,,2020-01-26T08:00:00Z,,,2020-01-26T08:00:00Z,2,2,2,0,0,0,0,0,e316555127f0df0f77128dc56e03715f2753eed1
20200125,1,2,0,,,,,,,,,2020-01-25T08:00:00Z,,,2020-01-25T08:00:00Z,2,2,2,0,0,0,0,0,f36ebcb6f4560105c7a4f41d86bfa6b298e06264
20200124,1,2,0,,,,,,,,,2020-01-24T08:00:00Z,,,2020-01-24T08:00:00Z,2,2,2,0,0,0,0,0,3961417b3aab3cd04d9e11e8ece9a069f94cead9
20200123,1,2,0,,,,,,,,,2020-01-23T08:00:00Z,,,2020-01-23T08:00:00Z,2,2,2,0,0,0,0,0,7a8e4c4e88248b46b2f97eecdb8311e25b21b549
20200122,1,2,0,,,,,,,,,2020-01-22T08:00:00Z,,,2020-01-22T08:00:00Z,2,2,2,0,0,0,0,0,6309a00e68b997f001ac368891a9408c12603e7c
